CONVERT v1.4B, (c) 1994 Jesus Villena
Converts sounds among several kinds of music and sample files

    Sintax:  CONVERT [InputPath/@SearchFile] [[OutputPath] [OutFmt] [Switches]]

	Switches 	Meaning
	---------	----------------------------------------------------
	-8		Force 8 Bit Conversion on Output File(s)
	-1		Force Mono Conversion on Output File(s)
	-b		Don't uses Bidirectional to Forward conversion
	-g		Correct the End part of a PAT file.

	OutFmt   	Output Format
	---------	----------------------------------------------------
	-AIF		Audio Interchange Format File (AIFF)
	-AU		Sun/Next Audio File
	-DSF		Delusion Digital Sound File
	-FAR,-FSM	Farandole Composer WaveSample
	-IFF		Interchange Format File (IFF)
	-SOU		SBStudio II Sound File
	-PAT		Gravis Ultrasound Patch
	-RAW		PCM Signed Raw Sound File
	-SBK		EMU SoundFont Bank (AWE32 Bank)
	-SDS		MIDI Sample DUMP Standard File
	-SDX		Sample DUMP Exchange File
	-SF		IRCAM Sound File
	-SMP		Samplevision File
	-SND		PCM Unsigned Raw Sound File
	-S3I		Digiplayer/ST3 Sample File
	-SYW		Yamaha SY-85/SY-99 Wave File
	-TXW		Yamaha TX-16W Wave File
	-UWF		UltraTracker WaveSample
	-VOC		Creative Lab's Sound File
	-WAV		Microsoft Windows RIFF WAVE
	-XI		FastTracker 2.0 Instrument
	-OUT		Extract individual files from the input file

	 You can generate proper instruments for some trackers with:
			-669, -DMF, -FAR, -F2R, -F3R, -GKH, -MOD, -STM,
			-MED, -OKT, -MTM, -PAC, -ULT, -S3M, -XM
